XXXXXXXXXXXXXXXXXXXXX
X                   X
X X XXX X XXXXXXX X X
X X X X X X     X X X
X X X X X X X XXX X X
X X X X X X X     X X
X X X X XXX XXX X X X
X X X X       X X X X
X X X X   XXX X X X X
X X X X   X X X X X X
X X X X XXX X X X X X
X X   X X   X X   X X
X X X X X X X XXX X X
X X X X X X X   X X X
X X X X X X XXX X X X
X X X X   X   X X X X
X X X XXX XXXXX XXX X
X X   X X     X     X
X XXXXX XXXXXXX     X
X             X     X
XXXXXXXXXXXXXXXXXXXXX