XXXXXXXXXXXXXXXXXXXXX
X           X       X
X XXX XXX X X XXXXX X
X X X   X   X X   X X
X X XXX XXX X X   X X
X X   X   X X X   X X
X X X X X X X X   X X
X X X X X   X X   X X
X X X XXX XXX X X X X
X X X     X   X X X X
X X X X XXX XXX X X X
X X X X X       X X X
X X X XXX XXX X X X X
X X X     X X X   X X
X X X X XXX XXX XXX X
X X X X X       X X X
X X X XXX XXXXXXX X X
X X X X   X       X X
X X XXX XXX XXXXXXX X
X                   X
XXXXXXXXXXXXXXXXXXXXX