XXXXXXXXXXXXXXXXXXXXX
X               X X X
X X XXX XXXXXXX X X X
X X     X     X X X X
X XXXXX X X   XXX X X
X     X   X       X X
X XXX XXXXX XXXXX X X
X X X X     X     X X
X X XXX XXX X XXX X X
X       X X   X X X X
X XXXXX X XXX X X X X
X X   X X   X X X X X
X X X X X X X X X X X
X X X X X       X X X
X X X X X XXXXX X X X
X X X X X X   X   X X
X X X X X X XXX X X X
X X X X X X X X X X X
X X X XXX X X X XXX X
X             X     X
XXXXXXXXXXXXXXXXXXXXX