XXXXXXXXXXXXXXXXXXXXX
X               X X X
X X XXX X X X XXX X X
X X X X X X X     X X
X X X X X X XXXXX X X
X X X           X X X
X XXX XXXXX   XXX X X
X       X X   X   X X
X XXXXX X XXXXX X X X
X X   X X       X X X
X X X X X XXXXX X X X
X X X X   X   X X X X
X X X XXXXX XXXXX X X
X X X           X X X
X X XXXXXXXXX X X X X
X X         X X   X X
X X XXX XXX X X XXX X
X X X X       X     X
X X X XXXXXXX XXXXX X
X                   X
XXXXXXXXXXXXXXXXXXXXX